11111111111111111111
1010P111001100000111
1E000000100100101001
10100000001000101101
11010001000100110101
10100000101011100011
1010100C011010110111
100011001110100000111
10001101110000110011
11111111111111111111