11111111111111111111
1010P1110011C0000111
1EC000C0100100101001
1C100000001000101101
11010001C0C10C110101
101000CC10101110C011
10101000C11010110111
10001100111C10000011
10001101110000110011
11111111111111111111