11111111111111111111
101P0011C0C00C000001
10000000100000100001
10000000000000100001
11000000000000111101
11100000000000000001
10001000011010110001
10001000000000000001
10001001110000110011
10000000000E00000001
10000000000000000001
10100011C0C00C000001
11111111111111111111